,A,B,C,D,E,F,G,H
0,F,R,R,X,R,R,M,M
1,R,X,R,F,R,R,R,M
2,X,C,X,R,R,X,R,R
3,C,T,C,X,S,R,R,V
4,X,C,X,R,F,R,X,W
5,R,X,R,R,R,R,V,W
6,R,F,S,R,X,V,W,W
7,R,R,X,R,V,W,W,W
