,A,B,C,D,E,F,G,H
0,L,L,L,L,L,L,M,M
1,L,L,L,L,L,L,L,M
2,L,L,L,L,L,L,L,L
3,L,T,L,L,L,L,L,L
4,L,L,L,L,L,L,L,W
5,L,L,L,L,L,L,L,W
6,L,L,L,L,L,L,W,W
7,L,L,L,L,L,W,W,W
