,A,B,C,D,E,F,G,H
0,0,950,950,800,950,1000,0,0
1,902,800,902,0,1000,950,1000,0
2,800,0,800,902,950,800,950,1000
3,0,0,0,800,0,950,950,400
4,800,0,800,902,0,950,320,0
5,902,800,902,1000,950,1000,152,0
6,1000,0,0,950,800,152,0,0
7,1000,950,800,950,380,0,0,0
